[
    ["#", "#", "#", "#", "#", "#", "#", "#", "#", "#", "#", "#", "#", "#", "#"], 
    ["#", "X", "#", "A", "#", "G", "#", "X", "#", "E", "#", "#", "#", "#", "#"], 
    ["#", "H", "#", " ", "#", " ", "#", " ", "#", " ", "#", "#", "M", "#", "#"], 
    ["#", " ", "#", "L", "#", " ", "#", " ", "#", "S", "#", "N", " ", "#", "#"], 
    ["#", "S", "#", "B", "#", "B", "#", "L", "#", "B", "#", "#", "*", "#", "#"], 
    ["#", "B", "#", " ", " ", " ", " ", " ", " ", " ", "#", "#", "X", "#", "#"], 
    ["#", " ", " ", " ", " ", " ", " ", " ", " ", " ", "*", " ", "H", "O", "#"], 
    ["#", " ", " ", " ", " ", " ", " ", " ", " ", "X", "#", "#", "C", "#", "#"], 
    ["#", " ", "#", "#", "#", "#", "#", "#", "#", "#", "#", "#", "#", "#", "#"], 
    ["#", " ", "#", "#", "X", "#", "#", "#", "#", "#", "#", "#", "#", "#", "#"], 
    ["#", "L", "#", "#", "H", "#", "E", " ", "L", " ", "#", "#", "A", "#", "#"], 
    ["#", " ", "#", "#", " ", "#", "C", " ", "#", " ", "B", " ", "P", "X", "#"], 
    ["#", " ", "#", "#", "B", "#", "#", "#", "#", " ", "#", "#", "C", "#", "#"], 
    ["#", "C", "L", " ", " ", " ", " ", " ", " ", " ", "#", "#", "#", "#", "#"], 
    ["#", "#", "#", "#", "#", "#", "#", "#", "#", "#", "#", "#", "#", "#", "#"], 
]